11111
1P001
11111
1E0C1
11111
