11111
1P1C1
11111
1E001
11111
